NO ./textures/wolf/brick.xpm
SO ./textures/wolf/stone.xpm
WE ./textures/wolf/cave.xpm
EA ./textures/wolf/wood.xpm

F 110,111,112
C 54,55,56

        1111111111111111111111111
        1000000000110000000000001
        1011000001110000000200001
        1001000000000000000000001
111111111011000001110000000000001
100000000011000001110111111111111
11110111111111011100000010001
11110111111111011101010010201
11000000110101011100000010001
10002000000000001100000010001
10000000000000001101010010001
11000001110101011111011110N01
11110111 1110101 101111010001
11111111 1111111 111111111111
